R 1000 1000
F 10,110,10
C 200 ,200 ,200
NO /Users/jyelena/cub3d/textures/redbrick.xpm
SO /Users/jyelena/cub3d/textures/greystone.xpm


WE /Users/jyelena/cub3d/textures/colorstone.xpm
EA /Users/jyelena/cub3d/textures/bluestone.xpm
S /Users/jyelena/cub3d/textures/barrel.xpm
11111111111111111111111111111111111111111111
10000000000000000000000000000000000000000001
10000000000002000000010000000000000000000101
10111111110000001110000011111111111111101111
10100000001000000000000001111111111111101111
10100000001111011100000000000000000000000011
10011110001 11011111100200000111111111000111
10000000001111000000000000000000001111100011
11111111111111111111111110011111111111111111
10000000000000000000000000000000011100000001
10000000000000000000000000000000000100000001
10000000000202020202020002000000011100000001
10000000000202020202020202000000000000000001
10000000000202020202020202000000000000000001
10000000000202020202020202000000E00000000001
10000000000202020202020202000000000000000001
10000000000202020202020202000000000000000001
10000000000000000000000000000000000000000001
10000000000000000000000000000000000000000001
10000000000000000000000000000000000000000001
11111111111111111111111111111111111111111111