R 1920  1080
F 220 , 100,0
C 225,30,0

NO /Users/jyelena/cub3d/textures/north.xpm
SO /Users/jyelena/cub3d/textures/south.xpm
WE /Users/jyelena/cub3d/textures/west.xpm
EA /Users/jyelena/cub3d/textures/east.xpm
S /Users/jyelena/cub3d/textures/lola.xpm

           111111
11111111111100011111111111111
1000000000000E000000000000011
11111111111100011111111111111
           1111111