 R 1920  1080
F 220 , 100,0
C 225,30,0

NO /home/dmikhaylov/CLionProjects/cub/textures/north.xpm
SO /home/dmikhaylov/CLionProjects/cub/textures/south.xpm
WE /home/dmikhaylov/CLionProjects/cub/textures/west.xpm
EA /home/dmikhaylov/CLionProjects/cub/textures/east.xpm
S /home/dmikhaylov/CLionProjects/cub/textures/lola.xpm

11111111111111111111111111111
1222222222222W222222222222211
11111111111111111111111111111