 R 1920  1080
F 220 , 100,0
 C 225,30, 0

NO /home/dmikhaylov/CLionProjects/cub3d/textures/north.xpm
SO /home/dmikhaylov/CLionProjects/cub3d/textures/south.xpm
WE /home/dmikhaylov/CLionProjects/cub3d/textures/west.xpm
EA /home/dmikhaylov/CLionProjects/cub3d/textures/east.xpm
S /home/dmikhaylov/CLionProjects/cub3d/textures/lola.xpm

111111111
111111111111111111111111
100111111111111111111111111111111111
1000000000000000000000000000000001
100000S0000000000000000000000000011
111000000000111111111111111111111111111111111
11111111111111111111111111111111111
1   1
11