R 1920 00001080


F 010 ,100,000090


 C 0000105,000030, 10


NO /home/dmikhaylov/CLionProjects/cub3d/textures/north.xpm
SO /home/dmikhaylov/CLionProjects/cub3d/textures/south.xpm


WE /home/dmikhaylov/CLionProjects/cub3d/textures/west.xpm
EA /home/dmikhaylov/CLionProjects/cub3d/textures/east.xpm
S /home/dmikhaylov/CLionProjects/cub3d/textures/lola.xpm


    111111111111111111111111111111111111
  1111111111000000000000111111111111111111111
  1111100000000000S000000000000000001111111
 1111111111000000000001111111111111111
  11111111111111111111111111111111

           1111111111111111111111
              111111111111000011
               11111111111111111